%%%%%%%%%%%%%%%%%%%%%%%%%%%%
%..........................%
%.%%.%%%%%%%.%%.%%%%%%%.%%.%
%.%%.%%%%%%%.%%.%%%%%%%.%%.%
%.%%...%%....%%....%%...%%.%
%.%%%%.%%.%%%%%%%%.%%.%%%%.%
%.%%%%.%%.%%%%%%%%.%%.%%%%.%
%.%%....................%%.%
%.%%.%%%%.%%%%%%%%.%%%%.%%.%
%.%%.%%%%.%%%%%%%%.%%%%.%%.%
%......%%.%%%%%%%%.%%......%
%.%%%%.%%..........%%.%%%%.%
%.%%%%.%%.%%%  %%%.%%.%%%%.%
%.%%%%.%%G%      %.%%.%%%%.%
%.........%      %.........%
%%%.%%%%%.%      %.%%%%%.%%%
%%%.%%%%%.%%%%%%%%.%%%%%.%%%
%......%%.........G%%......%
%.%%%%.%%.%%%%%%%%.%%.%%%%.%
%.%%%%.%%.%%%%%%%%.%%.%%%%.%
%...%%.......%%G......%%...%
%%%.%%.%%.%%%%%%%%.%%.%%.%%%
%%%.%%.%%.%%.%%.%%.%%.%%.%%%
.......%%.%%....%%.%%.......
%%%.%%.%%.%%%%%%%%.%%.%%.%%%
%%%.%%.%%.%%%%%%%%.%%.%%.%%%
%...%%.%%..........%%.%%...%
%o%%%%.%%%%%.%%.%%%%%.%%%%.%
%.%%%%.%%%%%.%%.%%%%%.%%%%.%
%...........P%%............%
%%%%%%%%%%%%%%%%%%%%%%%%%%%%
