%%%%%%%%%%%%%%%%%%%%%%%%%%%%
%                      P   %
% %% %%%%%%% %% %%%%%%% %% %
% %% %%%%%%% %% %%%%%%% %% %
% %%   %%    %%    %%   %% %
% %%%% %% %%%%%%%% %% %%%% %
% %%%% %% %%%%%%%% %% %%%% %
% %%                    %% %
% %% %%%% %%%%%%%% %%%% %% %
% %% %%%% %%%%%%%% %%%% %% %
%      %% %%%%%%%% %%      %
% %%%% %%          %% %%%% %
% %%%% %% %%%  %%% %% %%%% %
% %%%% %%G%      % %% %%%% %
%         %      %         %
%%% %%%%% %      % %%%%% %%%
%%% %%%%% %%%%%%%% %%%%% %%%
%      %%         G%%      %
% %%%% %% %%%%%%%% %% %%%% %
% %%%% %% %%%%%%%% %% %%%% %
%   %%       %%G      %%   %
%%% %% %% %% %% %% %% %% %%%
%%% %% %% %% %% %% %% %% %%%
%      %% %%    %% %%      %
%%% %% %% %%%%%%%% %% %% %%%
%%% %% %% %%%%%%%% %% %% %%%
%   %% %%          %% %%   %
%.%%%% %%%%% %% %%%%% %%%% %
% %%%% %%%%% %% %%%%% %%%% %
%            %%            %
%%%%%%%%%%%%%%%%%%%%%%%%%%%%
