%%%%%%%%%%%%%%%%%%%%%%%%%%%%
%                          %
% %% %%%%%%% %% %%%%%%% %% %
% %%.%%%%%%% %% %%%%%%% %% %
% %%   %%    %%    %%   %% %
% %%%% %% %%%%%%%% %% %%%% %
% %%%% %% %%%%%%%% %% %%%% %
% %%                    %% %
% %% %%%% %%%%%%%% %%%% %% %
% %% %%%% %%%%%%%% %%%% %% %
%      %% %%%%%%%% %%      %
% %%%% %%          %% %%%% %
% %%%% %%G%%%  %%% %% %%%% %
% %%%% %% %      % %% %%%% %
%         %      %         %
%%% %%%%% %      % %%%%% %%%
%%%G%%%%% %%%%%%%% %%%%% %%%
%      %%          %%      %
% %%%% %% %%%%%%%% %% %%%% %
% %%%% %% %%%%%%%% %% %%%% %
%   %%       %%       %%   %
%%% %% %% %% %% %% %% %% %%%
%%% %% %% %% %% %% %% %% %%%
%      %% %%    %% %%      %
%%% %% %% %%%%%%%% %% %% %%%
%%% %% %% %%%%%%%%G%% %% %%%
%   %% %%          %% %%   %
% %%%% %%%%% %% %%%%% %%%% %
% %%%% %%%%% %% %%%%% %%%%P%
%            %%            %
%%%%%%%%%%%%%%%%%%%%%%%%%%%%
