%%%%%%%%%%%%%%%%%%%%%%%%%%%%
%                      P   %
% %% %%%%%%% %% %%%%%%% %% %
% %% %%%%%%% %% %%%%%%% %% %
% %%   %%    %%    %%   %% %
%.%%%% %% %%%%%%%% %% %%%% %
% %%%% %% %%%%%%%% %% %%%% %
% %%                    %% %
% %% %%%% %%%%%%%% %%%% %% %
% %% %%%% %%%%%%%% %%%% %% %
%      %%G%%%%%%%% %%      %
% %%%% %%          %% %%%% %
% %%%% %% %%%  %%% %% %%%% %
% %%%% %% %      % %% %%%% %
%         %      %         %
%%% %%%%% %      %.%%%%% %%%
%%% %%%%% %%%%%%%% %%%%% %%%
%      %%          %%      %
% %%%% %% %%%%%%%% %% %%%% %
% %%%% %% %%%%%%%% %% %%%% %
%   %%       %%G      %%   %
%%% %% %% %% %% %% %% %% %%%
%%% %% %% %% %% %% %% %% %%%
%      %% %%    %% %%     G%
%%% %% %% %%%%%%%% %% %% %%%
%%% %% %% %%%%%%%% %% %% %%%
%   %% %%          %% %%   %
%.%%%% %%%%% %% %%%%% %%%% %
% %%%% %%%%% %% %%%%% %%%% %
%            %%            %
%%%%%%%%%%%%%%%%%%%%%%%%%%%%
