%%%%%%%%%%%%%%%%%%%%%%%%%%%%
%                      P   %
% %% %%%%%%% %% %%%%%%% %% %
% %% %%%%%%% %% %%%%%%% %% %
% %%   %%    %%    %%   %% %
% %%%% %% %%%%%%%% %% %%%% %
% %%%% %% %%%%%%%% %% %%%% %
%.%%                    %% %
% %% %%%% %%%%%%%% %%%% %% %
% %% %%%% %%%%%%%% %%%% %% %
%      %%G%%%%%%%% %%      %
% %%%% %%          %% %%%% %
% %%%% %% %%%  %%% %% %%%% %
% %%%% %% %      % %% %%%% %
%.        %      %         %
%%% %%%%% %      %.%%%%% %%%
%%% %%%%% %%%%%%%% %%%%% %%%
%      %%          %%      %
% %%%% %% %%%%%%%% %% %%%% %
% %%%% %% %%%%%%%% %% %%%% %
%   %%       %%      G%%   %
%%% %% %% %% %% %% %% %% %%%
%%% %% %% %% %% %% %% %% %%%
%      %% %%    %% %%     G%
%%% %% %% %%%%%%%% %% %% %%%
%%% %% %%.%%%%%%%% %% %% %%%
%   %% %%          %% %%   %
%.%%%% %%%%% %% %%%%% %%%% %
% %%%% %%%%% %% %%%%% %%%% %
%            %%            %
%%%%%%%%%%%%%%%%%%%%%%%%%%%%
