%%%%%%%%%%%%%%%%%%%%%%%%%%%%%%%%%%%%
%                                 P%
% %%%%%%%%%%%%%%%%%%%%%%% %%%%%%%% %
% %%   %   %      %%%%%%%   %%     %
% %% % % % % %%%% %%%%%%%%% %% %%%%%
% %% % % % %             %% %%     %
% %% % % % % % %%%%  %%%    %%%%%%G%
% %  % % %   %    %% %%%%%%%%      % 
% %% % % %%%%%%%%G%%        %% %%%%%
% %% %   %%       %%%%%%%%% %%     %
%    %%%%%% %%%%%%%      %% %%%%%% %
%%%%%%      %G      %%%% %% %      %
%      %%%%%% %%%%% %    %% %% %%%%%
% %%%%%%      %       %%%%% %%     %
%        %%%%%% %%%%%%%%%%% %%  %% %
%%%%%%%%%%                  %%%%%% %
%.         %%%%%%%%%%%%%%%%        %
%%%%%%%%%%%%%%%%%%%%%%%%%%%%%%%%%%%%